set adjMat {
{0 1 0 0 0 0 0 0}
{0 0 1 1 0 0 0 0}
{0 0 0 1 1 0 0 0}
{0 0 0 0 1 1 0 0}
{0 0 0 0 0 1 1 1}
{0 0 0 0 0 0 1 1}
{0 0 0 0 0 0 1 1}
{0 0 0 0 0 0 0 0}
}

set wMat {
{0 0 0 0 0 0 0 0}
{0 0 1 3 0 0 0 0}
{0 0 0 3 4 0 0 0}
{0 0 0 0 1 2 0 0}
{0 0 0 0 0 2 5 0}
{0 0 0 0 0 0 5 0}
{0 0 0 0 0 0 0 6}
{0 0 0 0 0 0 0 0}
}

set nodesList {
    {0 0 0 0}
    {1 0 0 0}
    {2 0 0 0}
    {3 0 0 0}
    {4 0 0 0}
    {5 0 0 0}
    {6 0 0 0}
    {7 0 0 0}
}
set T_temp 9